Usuario Base,Oponente,Tiros realizados,Tiros acertados,Tiros fallados,"Gano (1 si, 0 no)",Daño recibido = tiros recibidos
Mord86,Stin94,51,26,25,0,10
Mord86,Asro25,57,29,28,1,19
Mord86,Idin94,46,22,24,0,12
Mord86,Jado86,53,27,26,1,14
Stin94,Mord86,46,21,25,1,13
Stin94,Asro25,45,23,22,0,16
Stin94,Imre78,56,29,27,0,9
Stin94,Idin94,41,21,20,1,18
Stin94,Jado86,48,22,26,1,12
Imre78,Erll88,49,20,29,1,9
Imre78,Geon75,46,23,23,1,19
Imre78,Taan31,52,28,24,1,11
Imre78,Haan9,44,20,24,0,16
